111111111
000000000
000111000
000000000
111111111
